111111
100011
1P0111
1CCE11
111111