111111
1EC001
101P01
100001
111111