111111
1EC001
100P01
100001
111111