111111111111111111111111111111111
100000000000000000000000000000101
10P100000000000000000000000000101
111000000000000000000000000000101
100000000000000000000000000000101
100000000000000000000000000000101
100000000000000000C00000000000001
100000000000000000000000000000101
100000000000000000000000000000101
100000000000000000000000000000101
100000000000000000000000000000101
100000000000000000000000000000001
100000000000000000000000000000101
100000000000000000000000000000101
100000000000000000000000000000101
100000000000000000000000000000101
100000000000000000000000000000001
100000000000000000000000000000101
100000000000000000000000000000101
100000000000000000000000000000101
100000000000000000000000000000101
100000000000000000000000000000001
100000000000000000000000000000101
100000000000000000000000000000101
100000000000000000000000000000101
100000000000000000000000000000111
100000000000000000000000000000E01
111111111111111111111111111111111