111111111111
1C0C00C11E11
101C1001CCP1
1010C1C00101
111111111111