11111111
10C11E11
1001CCP1
1C000101
11111111